++++++++++++++++++++
++                ++
++ ++++++++++++++ ++
++          +++++ ++
+++++++++++ +++++ ++
+++++++++++ +++++ ++
+++++++++++ +++++ ++
+++++++++++ +++++ ++
+++++++++++ +++++ ++
+++++++++++ +++++s++
+++++++++++ ++++++++
+++++++     ++++++++
+++++++ ++++++++++++
+++++++     ++++++++
+++++++++++ ++++++++
+++++++     ++++++++
+++++++ ++++++++++++
+       ++++++++++++
+e++++++++++++++++++
++++++++++++++++++++
