++++++++++++++++++++
+++++ e    +++++++++
++++++++ +++++++++++
++++++++ +++++++++++
++++++++ +++++++++++
++++++++ +++++++++++
++++++++ +++++++++++
++++++++ +++++++++++
++++++++ +++++++++++
++++++++ +++++++++++
++++++++ +++++++++++
+++      +++++++++++
++++++++ +++++++++++
++++++++ ++++++  +++
++++++++ ++++++ ++++
++++++++        ++++
++++++++ +++++++++++
++++++++ +++++++++++
++      s     ++++++
++++++++++++++++++++



