++++++++++++++++++++
++++++++++++++++++++
++++++++      s+++++
++++++++ +++++++++++
++++++++ +++++++++++
++++++++ +++++++++++
++++++++ +++++++++++
++++++++e+++++++++++
++++++++++++++++++++



