++++++++++++++++++++
++s          +++++++
++++++++ +++++++++++
++++++++ +++++++++++
++++++++ +++++++++++
++++++++ +++++++++++
++++++++ +++++++++++
++++++++ +++++++++++
+++++          +++++
++++++++ +++++++++++
++++++++e+++++++++++
++++++++++++++++++++



