++++++++++++++++++++
+    +         +   +
+    +++ +++++++   +
+    +        s+   +
+    +++ +++++++   +
+      + +         +
+      + +         +
+      + +         +
+      + +         +
+      +e+         +
++++++++++++++++++++



