++++++++++++++++++++
++++++++++++++++++++
++s      +++++++++++
++++++++ +++++++++++
++++++++ +++++++++++
++++++++ +++++++++++
++++++++ +++++++++++
++++++++ +++++++++++
++++++++e+++++++++++
++++++++++++++++++++



