++++++++++++++++++++
++++++e+++++++++++++
++++++ +++++++++++++
++++++       +++++++
++++++++++++ +++++++
++++++++++++ +++++++
++++++++++++      ++
+++++++++++++++++s++
++++++++++++++++++++



