++++++++++++++++++++
+                +s+
+ ++++++++++++++ + +
+ ++++++++++++++ + +
+ ++++++++++++++ + +
+ ++++++++++++++ + +
+ ++++++++++++++ + +
+ ++++++++++++++ + +
+ ++++++++++++++ + +
+ ++++++      ++ + +
+ ++++++ ++++ ++ + +
+ ++++++ +e++ ++ + +
+ ++++++ + ++ ++ + +
+ ++++++ + ++ ++ + +
+ ++++++ +    ++ + +
+ ++++++ +++++++ + +
+ ++++++         + +
+ ++++++++++++++++ +
+                  +
++++++++++++++++++++
